BatchAlertDurationBusinessEventBatchHelp=Process events for batch jobs that takes longer than expected to execute
BatchAlertDurationBusinessEventBatchLabel=Process events for batch job duration
BatchAlertDurationBusinessEventDescription=Events generated if configured batch jobs takes longer to execute than expected
BatchAlertDurationBusinessEventName=Batch job duration alert
BatchAlertDurationFeatureLabel=Finance Toolbox: Long running batch job business events
BatchAlertDurationFeatureSummary=This features enables business events on batch jobs, that fires if a batch job has not ended after a set number of minutes
BatchAlertDurationFieldGroupLabel=Batch alerts
BatchAlertDurationHelp=Emits a business event if batch job takes longer than expected to complete
BatchAlertDurationLabel=Duration
BatchAlertDurationLatestEndTimeEventEmittedHelp=Alert business event for threshold has been emitted
BatchAlertDurationLatestEndTimeEventEmittedLabel=Alert threshold event emitted
BatchAlertDurationLatestEndTimeHelp=Threshold for when a business event will be emitted
BatchAlertDurationLatestEndTimeLabel=Alert threshold date/time
BatchAlertDurationLimitHelp=Threshold for how long a batch job can take, before an event gets raised
BatchAlertDurationLimitLabel=Max duration in minutes
BatchAlertDurationTookLongerThanExpected=Batch job %1 took longer than expected to execute
BatchJobBusinessEventMaintainHelp=Grants the ability to maintain batch job business events
BatchJobBusinessEventMaintainLabel=Maintain batch job business events
BusinessEventHasNotBeenConfigured=The business event '%1' has not been configured
CreateSelfServiceRoleRequestsHelps=Creates one or more role requests for a specified user
CreateSelfServiceRoleRequestsLabel=Create new role requests
D365FinanceToolboxProjectLabel=Finance Toolbox
ExchangeRateProviderCentralBankOfDenmark=Central Bank of Denmark
ExchangeRateProviderCentralBankOfDenmarkStatbank=Central Bank and Statistikbanken
ExchangeRateProviderDanmarksNationalbank=Danmarks Nationalbank
 ;LOCKED - Danish name for the Danish National Bank
ExchangeRateProviderDenmarkCentralBankEndpoint=Denmark central bank API endpoint
ExchangeRateProviderDenmarkStatbank=Statistikbanken
ExchangeRateProviderDSTMLFormatMissingVariable=Statistikbanken returned an unexpected formatted DSTML exchange rate table. Unable to use Statistikbanken
ExchangeRateProviderStatbankEndpoint=Statistikbanken API endpoint
ExchangeRateProviderStatbankExchangeRateType=Statistikbanken currency type
FinanceToolboxPRMAdministratorDescription=Grants the ability to administer privileged role management
FinanceToolboxPRMAdministratorLabel=Finance Toolbox: Privileged role management administrator
FinanceToolboxPRMProcessingServiceInvokeDescription=Grants the ability to invoke the processing service for privileged role management
FinanceToolboxPRMProcessingServiceInvokeLabel=Finance Toolbox: Invoke privileged role management processing service
FinanceToolboxPRMRequestEndUserDescription=Grants the ability to request roles for own user
FinanceToolboxPRMRequestEndUserLabel=Finance Toolbox: Privileged role management user
FinanceToolboxPRMRequestManagerDescription=Grants the ability to assign roles on behalf of user
FinanceToolboxPRMRequestManagerLabel=Finance Toolbox: Privileged role management request manager
FinanceToolboxPRMRequestWorkflowUserDescription=Grants the ability to use workflows related to privileged role management
FinanceToolboxPRMRequestWorkflowUserLabel=Finance Toolbox: Privileged role management workflow user
FinanceToolboxSystemMaintainHelp=Grants the ability to maintain system administration features in Finance Toolbox
FinanceToolboxSystemMaintainLabel=Finance Toolbox: Maintain system administration
NewLabel1=New Text
NumSeqPrivilegedRoleManagement=Privileged Role Management
PrivilegedRoleManagement=Privileged Role Management
PrivilegedRoleManagementFeatureLabel=Finance Toolbox: Privileged role management
PrivilegedRoleManagementFeatureSummary=This feature enables functionality that enables advanced role management, such as timeboxed role assignments
PrivilegedRoleManagementParametersHelp=Configuration of Privileged Role Management
PrivilegedRoleManagementParametersLabel=Privileged Role Management parameters
PrivilegedRoleManagementProcessingServiceHelp=Process requests and assignments in privileged role management
PrivilegedRoleManagementProcessingServiceLabel=Privileged role management processing
PrivilegedRoleManagementSetUpNumberSeq=Set up number sequences for Privileged Role Management
RoleAssignmentRoleCannotBeAssignedToUser=Role cannot be assigned to user
RoleAssignmentsEntityDescription=Grants the ability to view role assignments through an entity
RoleAssignmentsEntityLabel=View role assignments entity
RoleAssignmentsLabel=Role assignments
SelfServiceAssignment=Assignment
SelfServiceAssignmentEligibility=Role assignment eligibility
SelfServiceCaption=Role assignment
SelfServiceCreateRequestMaxEligibleTime=Max eligible time
SelfServiceEligibleRoles=Available roles for assignment
SelfServiceEligibleRolesToDateCannotBeInThePast=To date cannot be in the past
SelfServiceEligibleRolesToDateGreaterThanFromDate=To date needs to be greater than from date
SelfServiceEligibleRolesUserValueNotSpecified=User value needs to be specified
SelfServiceParameterCaption=Role assignment parameters
SelfServiceRequestModeAllUsers=All users
SelfServiceRequestModeAllUsersAllRoles=All users all roles
SelfServiceRequestModeOwnUser=Own user
SelfServiceRoleAllowAllRolesHelp=Skips check for eligibility when doing role requests
SelfServiceRoleAllowAllRolesLabel=Allow all roles
SelfServiceRoleAllowOverlapHelp=Allows multiple open requests for same roles
SelfServiceRoleAllowOverlapLabel=Allow overlapping requests
SelfServiceRoleAssignmentIdHelp=Identification of the role assignment
SelfServiceRoleAssignmentIdLabel=Assignment Id
SelfServiceRoleCreateNewRequest=Create new role request
SelfServiceRoleEligibilityIdHelp=Identification of the role eligibility
SelfServiceRoleEligibilityIdLabel=Eligibility Id
SelfServiceRoleEligibilityMaxHoursHelp=Maximum time a role can be active
SelfServiceRoleEligibilityMaxHoursLabel=Max duration
SelfServiceRoleMaxTimeHelp=The maximum amount of time in hours that an role can be requested for
SelfServiceRoleMaxTimeLabel=Maximum length of assignment
SelfServiceRoleRequestCreateNoRolesSelected=No roles selected
SelfServiceRoleRequestCreateUserNotExists=User %1 does not exist
SelfServiceRoleRequestDurationHelp=Requested duration of role assignment
SelfServiceRoleRequestDurationLabel=Duration
SelfServiceRoleRequestIdHelp=Identification of the role request
SelfServiceRoleRequestIdLabel=Request Id
SelfServiceRoleRequestOnlyShowMine=Only show mine
SelfServiceRoleRequestOnlyShowOpen=Only show open
SelfServiceRoleRequestReferenceHelp=Reference to the request originator
SelfServiceRoleRequestReferenceTypeHelp=Reference type for request references
SelfServiceRoleRequestReferenceTypeLabel=Reference type
SelfServiceRoleRequestReferenceTypeTicket=Ticket
SelfServiceRoleRequests=Role requests
SelfServiceroleRequestsAllUsers=Role requests (All users)
SelfServiceRoleRequestsAssignedToMe=Role requests assigned to me
SelfServiceRoleRequestSetStatusExpiredHelp=Ends the selected requests assignments
SelfServiceRoleRequestSetStatusExpiredLabel=End assignment
SelfServiceRoleRequestsHelp=Role requests and history
SelfServiceRoleRequestsJustificationHelp=Justification for the role request
SelfServiceRoleRequestsJustificationLabel=Justification
SelfServiceRoleRequestsListViewHelp=Shows all role requests
SelfServiceRoleRequestsListViewLabel=All role requests
SelfServiceRoleRequestsOutcomeReasonHelp=Reason for the outcome of the request
SelfServiceRoleRequestsOutcomeReasonLabel=Outcome reason
SelfServiceRoleRequestStatus=Request status
SelfServiceRoleRequestStatusForApproval=For approval
SelfServiceRoleRequestSubmittedToWorkflow=Submitted to workflow
SelfServiceRoleRequestsViewEntityDescription=Grants the ability to view role requests through an entity
SelfServiceRoleRequestsViewEntityLabel=View role requests entity
SelfServiceRoleRequestWorkflowApproveHelp=Approves the requested role
SelfServiceRoleRequestWorkflowApproveLabel=Approve request
SelfServiceRoleRequestWorkflowCancelHelp=Cancels the role request
SelfServiceRoleRequestWorkflowCancelLabel=Cancel request
SelfServiceRoleRequestWorkflowDelegateHelp=Delegates the approval to other approver
SelfServiceRoleRequestWorkflowDelegateLabel=Delegate approval
SelfServiceRoleRequestWorkflowDenyHelp=Denies the requested role
SelfServiceRoleRequestWorkflowDenyLabel=Deny request
SelfServiceRoleRequestWorkflowRequestApprovalHelp=Approval process for role request
SelfServiceRoleRequestWorkflowRequestApprovalLabel=Request approval
SelfServiceRoleRequestWorkflowResubmitHelp=Resubmits approval
SelfServiceRoleRequestWorkflowResubmitLabel=Resubmit
SelfServiceRoleRequestWorkflowSubmitHelp=Submits the request for approval
SelfServiceRoleRequestWorkflowSubmitLabel=Submit request
SelfServiceRoleRequestWorkflowTypeHelp=Workflow for user role requests
SelfServiceRoleRequestWorkflowTypeLabel=User role request
SelfServiceRoleRequireApprovalHelp=Require approval of role requests
SelfServiceRoleRequireApprovalLabel=Require approval
SelfServiceTmpSelectedRoleDateTimeCannotBeBefore=Date/time cannot be before %1
SelfServiceTmpSelectedRoleDurationGreaterThanMaxDuration=Duration cannot be greater than max duration
SelfServiceTmpSelectedRoleDurationNegative=Duration cannot be negative
SelfServiceTmpSelectedRoleLabel=Selected roles
SelfServiceTmpSelectedRoleMaxDuration=Duration cannot be greater than max duration
SelfServiceTmpSelectedRoleToDateBeforeFromDate=To date/time needs to be after from date/time
